~~~~~~~~~~~~~~~~~~~~~~~~~~
~##############~~~#######~
~#............#~~~#.....#~
~#.............,,,......#~
~#............#~~~#.....#~
~#####.########~~~#.....#~
~~~~~~,~~~~~~~~~~~#.....#~
~~~~~~,~~~~~~~~~###.....#~
~#####.#####~~~~#.......#~
~#.........#~~~~#.......#~
~#..........,,,,........#~
~#.........#~~~~#.......#~
~###########~~~~#.......#~
~~~~~~~~~~~~~~~~#########~
