                                     
   ###################   #########   
   #.................#   #.......#   
   #.................#...#.......#   
   #.................#   #.......#   
   #.................#   #####.###   
   #.................#        .      
   ####.#########.####        .      
       .         .            .      
       .         .            .      
       .         .            .      
       ...........            .      
       .                      .      
       .                      .      
       .                      .      
       .                ######.##### 
   ####.######          #..........# 
   #.........#          #..........# 
   #...............................# 
   #.........#          #..........# 
   #.........#          #..........# 
   ###########          ############ 
                                     
