                               
                               
                               
     #######     ##########    
     #.....#     #........#    
   ###.....+,,,,,+........#### 
   #.......#     #...........# 
   #.......#     #####.......# 
   #.......#         #.......# 
   ####...##         #.......# 
      ##+##          ####+#### 
        ,                ,     
        ,                ,     
        ,,,,,,,,,,,,,,,,,,     
        ,                ,     
        ,                ,     
   #####+#####      #####+###  
   #.........##    ##.......#  
   #..........+,,,,+........#  
   #.........##    #........#  
   ###########     #........#  
                   ##########  
                               
                               
                               
