                                     
   #############         #########   
   #...........#         #.......#   
   #.....................#.......#   
   #...........#    .    #.......#   
   #...........#    .    #####.###   
   #...........#    .         .      
   ####.########    .         .      
       .            .         .      
       .            .         .      
       .            .         .      
       ..............         .      
       .                      .      
       .                      .      
       .                      .      
       .                ######.##### 
   ####.######          #..........# 
   #.........#          #..........# 
   #...............................# 
   #.........#          #..........# 
   #.........#          #..........# 
   ###########          ############ 
                                     
