                                     
                                     
     ###############     #########   
     #.............+.....+.......#   
     #.............#     #.......#   
     #.............#     #.......#   
     #.............#     #####+###   
     ##+############          .      
       .                      .      
       .                ######+####  
       ............     #.........#  
       .          .     #.........#  
       .          .     #.........#  
   ####+######    .     #.........#  
   #.........#    .     #.........#  
   #.........+..........+.........#  
   #.........#          #.........#  
   ###########          ###########  
                                     
                                     
