#######################
#.......#.............#
#..~~~~~#.............#
#######################
#..~~~~~..............#
#..~~~~~..............#
#######################
#..~~~~~..............#
#..~~~~~..............#
#..~~~~~..............#
#..~~~~~..............#
#..~~~~~..............#
#..~~~~~..............#
#..~~~~~..............#
#.....................#
#.....................#
#.....................#
#######################
