                               
                               
                               
   #########     ############# 
   #.......#     #...........# 
   #.......+,,,,,+...........# 
   #.......#     #...........# 
   #.......#     #...........# 
   #.......#     #...........# 
   #.......#     #...........# 
   #####+###     ########+#### 
        ,                ,     
        ,                ,     
        ,,,,,,,,,,,,,,,,,,     
        ,                ,     
        ,                ,     
   #####+#####      #####+###  
   #.........##    ##.......#  
   #..........+,,,,+........#  
   #.........##    #........#  
   ###########     #........#  
                   ##########  
                               
                               
                               
