                                     
   #################     #########   
   #...............#     #.......#   
   #...............#.....#.......#   
   #...............#     #.......#   
   #...............#     #####.###   
   #...............#          .      
   ####.############          .      
       .                      .      
       .                      .      
       .                      .      
       ........................      
       .           .          .      
       .           .          .      
       .           .          .      
       .           .    ######.##### 
   ####.######     .    #..........# 
   #.........#     .    #..........# 
   #...............................# 
   #.........#          #..........# 
   #.........#          #..........# 
   ###########          ############ 
                                     
