     #,#        #,#      
     #,#        #,#      
  ####+###   ####+#####  
###......#####........###
,,+......+,,,+........+,,
###......#####........###
  #......#   #####+####  
  #......#       #,#     
  ####+###       #,#     
     #,#         #,#     
     #,#      ####+####  
     #,#      #.......#  
  ####+####   #.......#  
###.......#####.......###
,,+.......+,,,+.......+,,
###.......#####.......###
  ####+####   ###+#####  
     #,#        #,#      
     #,#        #,#      
