~~~~~~~~~#~~~~~~~~~~~~~~~~~#~~~~~~~~~
~~~~~~~~~#~~~~~~~~~~~~~~~~~#~~~~~~~~~
~~~~############~~~~~~~~~~~#~~~~~~~~~
~~~~############~~~~~~############~~~
~~~~############~~~~~~############~~~
#####################################
~~~~############~~~~~~############~~~
~~~~############~~~~~~############~~~
~~~~############~~~~~~~~~~~~~~#~~~~~~
~~~~~~~~~~#~~~~~~~~~~~~~~~~~~~#~~~~~~
~~~~~~~~~~#~~~~~~~~~~~~~~~~~~~#~~~~~~
~~~~~~~~~~#~~~~~~~~~~~~~~~~~~~#~~~~~~
~~~~~~~~~~#~~~~~~~~~~~~~~~~~~~#~~~~~~
~~~~~~~~~~#~~~~~~~~~~~~~###########~~
~~~###########~~~~~~~~~~###########~~
~~~###########~~~~~~~~~~###########~~
~~~###########~~~~~~~~~~###########~~
##############~~~~~~~~~~#############
~~~################################~~
~~~###########~~~~~~~~~~###########~~
~~~###########~~~~~~~~~~###########~~
~~~~~~~~#~~~~~~~~~~~~~~~~~~~~~#~~~~~~
~~~~~~~~#~~~~~~~~~~~~~~~~~~~~~#~~~~~~
