                                 
                                 
     #######       ########      
     #.....#       #......#      
   ###.....+,,,,,,,+......#      
   #......##    ,  #####+##      
   #......#     ,       ,        
   #......#     ,       ,        
   ########     ,    ###+#####   
                ,    #.......#   
                ,,,,,+.......#   
                     #########   
                                 
