                            
 #########       ###########
 #.......#       #.........#
 #.......+,,,,,,,+.........#
 #.......#       #.........#
 #####+###       ######+####
      ,                ,    
      ,                ,    
      ,,,,,,,,,,,,,,,,,,    
      ,                ,    
      ,                ,    
 #####+######     #####+### 
 #..........#     #.......# 
 #..........+,,,,,+.......# 
 #..........#     #.......# 
 ############     #.......# 
                  ######### 
